ぎt	git	名詞	
bれw	brew	名詞	
どcけr	docker	名詞	
こmぽせ	compose	名詞	
てst	test	名詞	
ぱcかげ	package	名詞	
cぇあn	clean	名詞	
やrn	yarn	名詞	
ぉかlほst	localhost	名詞	
ゔぃm	vim	名詞	
ぞおm	zoom	名詞	
おうtぉおk	outlook	名詞	
おゔぃせ	ovice	名詞	
まいn	main	名詞	
こで	code	名詞	
でゔぇぉp	develop	名詞	
ちぇcこうt	checkout	名詞	
すぃtch	switch	名詞	
ふぇあつれ	feature	名詞	
mvn	mvn	名詞	
てあms	teams	名詞	
cれあて	create	名詞	
ぱうせ	pause	名詞	
ぎてゅb	github	名詞	
ぽうぇrぽいんt	powerpoint	名詞	
ぽうぇr	power	名詞	
ので	node	名詞	
んpm	npm	名詞	
